
NO  ./textures/wolf3D_bluestone.xpm

SO         ./textures/wolf3D_colorstone.xpm

WE          ./textures/wolf3D_mossy.xpm

EA ./textures/wolf3D_purplestone.xpm

F         220,100,255

C 225,30,0

111

         1   1111111
111111111011111111111111
1000000000110000000000001
1011000001110000000000001
10010000000000000000000011111111
111111111011000001110000000000001
100000000011000001110111111111111
11110111111111011100000010001
11110111111111011101010010001
11000000110101011100000010001
10000000000000001100000010001
10000000000000001101010010001
11000001110111011111011110N0111
11110111 111 101 101111010001
11111111 1111111 111111111111