
NO  ./textures/wolf3D_bluestone.xpm

SO         ./textures/wolf3D_colorstone.xpm

WE          ./textures/wolf3D_mossy.xpm

EA ./textures/wolf3D_purplestone.xpm

F         220,100,255

C 225,30,0

1111111111
1000000001
1000000001
1000000001
1000000001
1000000001
1000N00001
1000000001
1000000001
1001000101
1111111111
