
NO          ./textures/wolf3D_bluestone.xpm

SO         ./textures/wolf3D_colorstone.xpm

WE          ./textures/wolf3D_mossy.xpm

EA ./textures/wolf3D_purplestone.xpm

F         220,100,255

C 225,30,0

11111111111111111111111111111
10000000000000000000000000001
10000000000000000000000100001
10011100000000000000000100001
10010100000000000000000100001
10011100000000000000000111111
10000000000000000000000000001
1E000000000000000000010000001
10000000000000000000000000001
10010001000000000010001000001
11111111111111111111111111111
