
NO          ./textures/wolf3D_bluestone.xpm

SO         ./textures/wolf3D_colorstone.xpm

WE          ./textures/wolf3D_mossy.xpm

EA ./textures/wolf3D_purplestone.xpm

F         220,100,255

C 225,30,0

11111111111111111111111111111
10000000000000000000000000001111111111111111111
10000000000000000000000000000000000000000000001
10000000000000000000000100001111111111111111111
10011100000000000000000100001
10010100000000000000000100001
10011100000000000000000111111
10000000000000000000000000001
10000000000000000000010000001
10000000000000000000000000001
10010001111100000001111100001
1000001     10000S11    10001
1000001     1000001     10001
1111111     1111111     11111
